0;2;3;1;3;1;2;0;2;3;4;3;1;2;0
0;2;1;3;4;3;2;0;2;1;3;1;3;2;0
0;1;0;0;0;0;1;0;1;0;0;0;0;1;0
0;1;0;0;0;0;1;0;1;0;0;0;0;1;0
0;3;0;0;0;0;3;0;3;0;0;0;0;3;0
0;4;0;0;0;0;1;0;1;0;0;0;0;1;0
0;2;0;0;0;0;1;0;1;0;0;0;0;1;0
0;0;0;0;0;0;3;0;3;0;0;0;0;3;0
0;0;0;0;0;0;4;0;1;0;0;0;0;1;0
0;0;0;0;0;0;1;0;4;0;0;0;0;4;0
0;0;0;0;0;0;3;0;2;1;3;1;3;2;0
0;0;0;0;0;0;1;0;2;3;1;3;1;2;0
0;0;0;0;0;0;1;0;0;0;0;0;0;1;0
0;2;3;4;3;1;2;0;0;0;0;0;0;3;0
0;2;1;3;1;3;2;0;0;0;0;0;0;1;0
0;1;0;0;0;0;1;0;0;0;0;0;0;1;0
0;3;0;0;0;0;4;0;0;0;0;0;0;3;0
0;1;0;0;0;0;3;0;0;0;0;0;0;1;0
0;1;0;0;0;0;1;0;0;0;0;0;0;4;0
0;3;0;0;0;0;1;0;0;0;0;0;0;3;0
0;1;0;0;0;0;3;0;0;0;0;0;0;1;0
0;1;0;0;0;0;1;0;0;0;0;0;0;1;0
0;2;4;3;1;3;2;0;2;3;1;3;1;2;0
0;2;3;1;3;1;2;0;2;1;3;4;3;2;0
