4;3;3;3;3;3;3;3;3;3;3;3;3;3;4
3;1;1;1;1;1;1;1;1;1;1;1;1;1;3
3;1;1;1;1;1;1;1;1;1;1;1;1;1;3
3;1;1;1;1;1;1;1;1;1;1;1;1;1;3
3;1;1;1;1;1;1;1;1;1;1;1;1;1;3
3;1;1;1;1;1;1;1;1;1;1;1;1;1;3
3;1;1;1;1;1;1;1;1;1;1;1;1;1;3
3;1;1;1;1;1;1;1;1;1;1;1;1;1;3
3;1;4;1;1;1;1;4;1;1;1;1;4;1;3
3;1;1;1;1;1;1;1;1;1;1;1;1;1;3
3;1;1;1;1;1;1;1;1;1;1;1;1;1;3
3;1;1;1;1;1;1;1;1;1;1;1;1;1;3
3;1;1;1;1;1;1;1;1;1;1;1;1;1;3
3;1;1;1;1;1;1;1;1;1;1;1;1;1;3
3;1;1;1;1;1;1;1;1;1;1;1;1;1;3
3;1;1;1;1;1;1;1;1;1;1;1;1;1;3
3;1;1;1;1;1;1;1;1;1;1;1;1;1;3
4;3;3;3;3;3;3;3;3;3;3;3;2;3;4
0;0;0;0;0;0;0;2;0;0;0;0;0;0;0
0;0;0;0;0;0;0;2;0;0;0;0;0;0;0
0;0;0;0;0;0;0;2;0;0;0;0;0;0;0
0;0;0;0;0;0;0;2;0;0;0;0;0;0;0
0;0;0;0;0;0;0;2;0;0;0;0;0;0;0
0;0;0;0;0;2;2;2;2;2;0;0;0;0;0
